111111111111111111
100000010000000001
1E1000110110110101
111010100000000111
100010100010000101
101000101010100101
101000111010110101
1P0010000000100001
111111111111111111