111111111111111111
10000C100C0000001
1E1000110110110101
111010100000000111
1C0010100010C001C1
101000101010100101
101C0011101C110101
1P00100C0000100001
111111111111111111
